wwwwwwww
s   w  w
ww    ww
w      w
w  w   w
e      w
wwwwwwww